###########################
#P                        #
# ##### ###### ########## #
#     # #    #          # #
# ### # # ## ###### ### # #
# #   #   ##  B    #     ##
# # ### ##  ## ###### ### #
# #     ##     #    # #   #
# ####### ###  #    # ## ##
#          #   ### ## ##  #
# ########## ####   #     #
#   B             B     F #
###########################
