############################
#P                        B#
# ### ### ######## ### ### #
# ### ### ######## ### ### #
#B### ### ###BB### ### ###B#
#B###B### ###BB### ### ###B#
# ### ### ######## ### ### #
# ### ###B######## ### ### #
#B### ### ###BB### ### ###B#
#B### ### ###BB### ### ###B#
# ###B###B######## ### ### #
# ### ### ########B### ###B#
#B                        F#
############################
