###########################
#P            B           #
######### #####  ######   #
#       # #   #       #  ##
####    # #   #  # #  #   #
#  #    # #   #  # #  ##  #
#  #  ### #   #### #BB#   #
#  #      ###      #  #  ##
#     ### #    ### #      #
#  #### # # #### # #  ##  #
#       # #      # B  #   #
######### #  #######  #B###
#      B           B      F
###########################